NO texture_north.xpm
SO texture_south.xpm
WE texture_west.xpm
EA texture_east.xpm

    1111111111111111111
    1001001001001001001
    1001001001001001111
    1111001001001001001
1001001000001001001
100000000S000000001
1000011111111000001
1111000000000001111
1000000101010000001
1111111111111111111


